R 640 480
NO img/texture.xpm
SO img/texture.xpm
WE img/texture.xpm
EA img/texture.xpm
S texture.xpm
F 0,0,0
C 0,0,0

1111111
1000001
10N0001
1000001
1111111
