R 1080 920
NO leavesop.xpm
SO texture.xpm
WE texture.xpm
EA texture.xpm
S texture.xpm
F 255,121,0
C 125,80,0

111111111111111111
100000000000000001
100000000000000001
100000000000000001
100000000000000001
100000000000000001
100000000000000001
10000000000000N001
100000000000000001
111111111111111111
10011001
10011001
10000001
11111111
