R 640 480
NO texture.xpm
SO texture.xpm
WE texture.xpm
EA texture.xpm
S texture.xpm
F 255,121,0
C 125,80,0
11111111111111111111111111111111
10000000000000000000000000000001
10000000000000000000000000000001
10000000000000000000000000000001
10000000000000000000000000000001
10000000000000000000000000000001
10000000000000000000000000000001
10000000000000000000000000000001
10000000000000000000000000100001
10000000000000000000000000100001
10000000000000000000000001100001
10000000000000000100000000100001
10000000000000000111000000100001
10000000000000000000000000100001
11111111111111111111111111111111
