R 1080 920
NO leavesop.xpm
SO texture.xpm
WE texture.xpm
EA texture.xpm
S texture.xpm
F 255,121,0
C 125,80,0

11111111111111111111111111111111
10001000100000000000000000000001
10001000100000000000010000000001
10001000100000000000010000000001
10111000100010000000000000000001111111111
11110011100011100000000000000000000000001
   10000000011110000000000000000001111111   
11110000000010000000000000000001111
10000000000010000000000000100001
10000000000000000000000000100001
10000000000000000000000001100001
10000000000000000100000000100001
10000000000000000111000000100001
10000000000000000000000000100001
11111111111111111111111111111111
